01110000000000000000000000000000
00010000000000000000000000000000
00010000000000000000000001110000
00010000000000000000000010000100
00010000000000000000000010000100
00011110111110000000011000000000
00000000000010000000000000000100
00000000000010000000100000000000
00000000000010000000100000000000
00000000000010000000100000000100
00000000000000000000100000000000
00000000000010000000000000000000
00000000000010000000000000000100
00000000000010000000100000000000
00000000000010000000100000111000
00000000000000000100000100000000
00000000000000000000000000000000
00000000000010000000000000000000
00000000000010001000000010000000
00000000000010001000000000010000
00000000000010001000000000000000
00000000000010001000000000000000
00000000000010000000000000100000
00000000000010000000000100000000
00011001111100001000000000000000
01000000000000001000000000000000
01000000000000001000000000000000
01000000111111100000000000000000
01000001000000000000000000000000
00000001000000000000000000000000
00111100000000000000000000000000
00000000000000000000000000000000